###########
#.$$$E$$$.#
#.$#$.$#$.#
#.$$$.$$$.#
#@#######.#
#.........#
#..#...#..#
#.........#
###########